elementId,cellType,x,y,signalStrength
0,电源,0,4,10
1,灯,0,8,1
2,灯,3,8,1
3,灯,6,2,1
4,灯,8,7,1
5,灯,9,0,1
6,放大器,0,0,15
7,放大器,3,6,10
8,放大器,5,0,10
9,墙,0,1,
10,墙,0,2,
11,墙,0,3,
12,墙,1,3,
13,墙,2,3,
14,墙,3,3,
15,墙,2,5,
16,墙,2,6,
17,墙,2,7,
18,墙,2,8,
19,墙,3,6,
20,墙,5,4,
21,墙,5,5,
22,墙,5,6,
23,墙,3,0,
24,墙,3,1,
25,墙,4,1,
26,墙,5,1,
27,墙,6,1,
28,墙,7,1,
29,墙,7,2,
30,墙,7,3,
31,墙,8,3,
32,墙,8,6,
33,墙,7,6,
34,墙,7,7,
35,墙,7,8,
36,墙,3,5,
